5 10
1 1
4 3
......%>}-
.>....%vW|
...#..%<{Q
......%^Mp
....QQ%#%q