10 10
0 0
0 0
>........p
.%..Q.....
.p........
......p%..
..........
..%p......
.....p....
.....%....
p.........
........p.